1111111111111111111111
1000000010100000001C11
100C000011100001000001
1000010000000111000001
1111110P001C01C0000111
1111C00000C10001100111
100001110EC0000C100011
1111111111111111111111
